10702305002
10602005002
10602005004
90601036001
90601035001
90601034002
90601034001
80601002004
80601002002
10701407004
40702003010
40702003002
40702003008
40702003004
80702324004
80702324002
80702324008
80702324006
40701002002
