10502003002
30001012002
30001026002
30001026003
30001026005
30001026007
30002021007
30101027002
30101036002
30101049002
30302002002
30302002006
30402026002
30402028002
30402028004
30410001002
30410002002
40001014002
40001014003
40001014004
40001014006
40001014007
40001014009
40001014010
40001014012
40001014013
40001014015
40001014016
40001014018
40001014020
40001014022
40001014023
40001015002
40001015005
40014001001
40014002001
40014003001
40014004001
40014007001
40014011002
40014022001
40014023001
40014024001
40014026001
40014027001
40014028002
40014030001
40014031001
40101001002
40101015004
40501004002
40501004004
80001002004
80001044004
80102101002
80201050002
80201050004
80201050006
80201050008
80202012006
80202014002
80202015004
90201020002
90201026002
90201036002
90302321004
90401335002
90401373002
30102054004
80302302006
80302302010
10110001002
10110002002
10110003002
10110004002
10110005001
10210001002
10210001003
10311001002
10311001004
10311001006
10311001008
10402002002
10402002004
10402002006
10402004002
10402004004
10402004006
10502002002
10502002004
10502006002
10502007002
10502010001
10502010003
10602003002
10602003004
10610007002
10610010001
10610015001
10610020001
10610025001
10610030001
10610035001
10402007001
30202027002
30001014002
30001045002
30001045004
30002034008
40301003002
50311003002
90501309002
40301001002
10202005002
30101053004
90201021004
90201021006
30501023002
80402308004
30364004002
90601320002
10002021001
80202013003
90402313004
40014005001
40014006001
40014008002
90401331002
90001002002
60002032002
60002032004
60002032006
60002032008
60402007002
90101008002
50002043002
10002008001
80402015002
80402015004
80302310002
80302310004
80302312001
80302312002
80402304002
80402304004
10402603002
10402604001
10402606002
90401311002
90401311004
90401311006
90401314002
